2 13 31
###############################
#p * *2       *  ** * *      *#
# # # # #*# # #*# # # # # #*# #
#  s * * *** **      *    **  #
# #*# # # # #1# #b#1# # # # #*#
#        3 *6    **      *  **#
# # #*# # # # # #*#*#*#*# # # #
#   *        *   * *x* *      #
# # # # #*# # # # # # #*# #*# #
#   ****  4      *1           #
# # # # # # # # # #*# # # # #*#
#  ** *   *    2          5   #
###############################